%s An update is available=%s E' disponibile un aggiornamento
Alert Message=
anonymous=anonimo
Author=Autore
Check For Updates=Controlla Aggiornamenti
Checking connectivity=Controllo connettivit√†
checking=controllo
Click here to install version %s=Clicca qui per installare la versione %s
Delete Plugin=Cancella Plugin
DOWNGRADE TO VERSION=DOWNGRADE ALLA VERSIONE
Enter URL of remote plugin file or local plugin file=Inserisci l'URL del plugin remoto o il file del plugin locale
ERROR=ERRORE
Install Plugin=Installa Plugin
Install=Installa
install=installa
Installed Plugins=Plugin installati
Installing Update=Installo Aggiornamento
need check=occorre un controllo
Next=Successivo
No plugins installed=Nessun plugin installato
No release notes available=Nessuna nota di rilascio
No response, aborting=Nessuna risposta, abbandono
Plugin File Install Errors=Errori di installazione File del Plugin
Plugin File=File del Plugin
Plugin History=Storia del Plugin
Plugin Update Check=Controlla Aggiornamenti Plugin
Plugin=Plugin
Release Notes=Note di rilascio
Remove Plugin=Rimuovi Plugin
Remove Selected Plugins=
remove=rimuovi
Select local plugin file=Seleziona file plugin locale
Stable=Stabile
STALE=SCADUTO
Support Thread=Discussione di supporto
Uninstall=Disinstalla
Update All Plugins=Aggiorna Tutti i Plugin
Update Plugin=Aggiorna Plugin
Upgrade=Aggiorna
View Release Notes=Vedi le Note di Rilascio

; Note: March 17, 2023 - 2 missing translations
