20 EHCI=2.0 (EHCI)
30 nec XHCI=3.0 (nec XHCI)
30 qemu XHCI=3.0 (qemu XHCI)
Allocation=Allocazione
and if using graphics device passthrough it too needs UEFI=e se usi il passthrough di schede grafiche hai bisogno dell'UEFI
Are you sure=Sei sicuro
Array must be started to view Virtual Machines=L'Array deve essere avviato per visualizzare le Macchine Virtuali
Autostart=Start automatico
Back=Indietro
Bus=Bus
Capacity=Capacità
Change Icon=Cambia Icona
Cleanup=Pulisci
Click and Select cdrom image to install operating system=Clicca e Seleziona l'immagine cdrom per installare il sistema operativo
Config Folder=Cartella di Configurazione
Copy Paste Domain XML Configuration Here=Copia Incolla la Configurazione XML del Domino Qui
CPU Mode=Modalità CPU
CPUs=CPUs
Create=Crea
Creating=Creando
define the amount memory=definisci la quantità di memoria
define the maximum amount of memory=definisci la quantità massima di memoria
define type of cpu presented to this vm=definisci tipo cpu presentato a questa vm
description of virtual machine=descrizione macchina virtuale
Disk devices=Periferiche Disco
Download Folder=Cartella di Donwload
Download, Click and Select virtio drivers image=Download, Clicca e Seleziona i driver virtio
Downloading=Scaricando
eg=per es.
Emulated=Emulato
ETA=ETA
Extracting=Estraendo
Folder to save the LibreELEC image to=Cartella in cui salvare l'immagine LibreELEC
Folder to save the OpenELEC image to=Cartella in cui salvare l'immagine OpenELEC
Form View=Visualizza Form
free=liberi
Graphics Card=Scheda Grafica
Graphics ROM BIOS=ROM BIOS Scheda Grafica
Graphics=Grafica
Guest not running or guest agent not installed=Ospite non esecuzione o agente ospite non installato
Host Passthrough=Host Passthrough
Hyperv tweaks for Windows=tweak Hyerv per Windows
Hyper-V=Hyper-V
i440fx will work for most=i440fx funzionerà quasi sempre
Icon=Icona
Initial=Iniziale
Interfaces=Interfacce
Invalid storage path=Percorso storage non valido
Invalid VM to edit=VM non valida per l'edit
IP Address=Indirizzo IP
ISO storage path doesnt exist, please create the user share or empty folder first=il percorso per gli ISO non esiste, prima crea una share o una cartella vuota
ISO storage path doesnt exist=il percorso per gli ISO non esiste
ISO storage path was empty=il percorso per gli ISO era vuoto
keyboard for VNC=tastiera per VNC
LibreELEC Version=Versione LibreELEC
LibreELEC=LibreELEC
Libvirt Service failed to start=fallito avvio Servizio Libvirt
Logical CPUs=CPU Logiche
Machine=Macchina
Manual=Manuale
Max=Max
MD5 verification failed, your download is incomplete or corrupted=verifica MD5 fallita, il tuo download è in completo o corrotto
mount tag inside vm=tag di mount nella vm
My Workstation=la mia Workstation
name of mount tag inside vm=nome del tag di mount nella vm
Name of virtual machine=Nome della macchina virtuale
Network Bridge=Bridge Network
Network MAC=MAC Network
Network Model=Modello Network
No Virtual Machines installed=Nessuna Macchina Virtuale installata
None available=Nessuno disponibile
Not enough free space, need at least=Non abbastanza spazio, servono almeno
Not running=Non in esecuzione
OpenELEC Version=Versione OpenELEC
OpenELEC=OpenELEC
OS Install CDRom Bus=Bus CDRom installazione OS
OS Install ISO=ISO Installazione OS
Other PCI Devices=ALtre periferiche PCI
OVMF requires a UEFI-compatable OS=OVMF richiede un OS compatibile con UEFI
OVMF TPM=OVMF TPM
OVMF=OVMF
password for VNC=password per VNC
path of Unraid share=percorso della share Unraid
path on Unraid share to save LibreELEC settings=percorso della share Unraid dove salvare le impostazioni LibreELEC
path on Unraid share to save OpenELEC settings=percorso della share Unraid dove salvare le impostazioni OpenELEC
Path to ROM BIOS file=Percorso file ROM BIOS
Please choose a folder the LibreELEC image will download to=Scegli una cartella in cui scaricare l'immagine LibreELEC
Please choose a folder the OpenELEC image will download to=Scegli una cartella in cui scaricare l'immagine OpenELEC
Pop-up Blocker is enabled Please add this site to your exception list=Blocco Pop-up attivo Aggiungi questo sito alla lista esclusioni
Prefix=Prefisso
Primary=Primario
Q35 for a newer machine model with PCIE=Q35 per una macchina più recente con PCIE
QEMU64=QEMU64
random mac, you can supply your own=mac random, puoi fornire il tuo
re-generate random mac address=rigenera un indirizzo mac casuale
Remove LibreELEC image=Rimuovi immagine LibreELEC
Remove OpenELEC image=Rimuovi immagine OpenELEC
Remove this LibreELEC file=Rimuovi questo file LibreELEC
Remove this OpenELEC file=Rimuovi questo file OpenELEC
SeaBIOS will work for most=SeaBIOS funzionerà quasi sempre
SeaBIOS=SeaBIOS
Select the BIOS=Seleziona il BIOS
Select the LibreELEC version to use=Seleziona quale versione di LibreELEC utilizzare
Select the machine model=Seleziona il modello della macchina
Select the OpenELEC version to use=Seleziona quale versione OpenELEC utilizzare
Select the USB Controller to emulate=Seleziona il Contoller USB da emulare
Separate sub-folder and image will be created based on Name=Separa le sottocartelle e l'immagine sarà creata basata sul Nome
shares=share
Some OSes wont support USB3=Alcuni OS non supportano USB3
Sound Card=Scheda Audio
Specify a ISO storage path first=Prima specifica una cartella per le ISO
Start All=Avvia Tutte
Start VM after creation=Avvia VM dopo la creazione
Stop All=Ferma Tutte
Toggle VM autostart=Alterna l'autostart delle VM
type of storage image=tipo di immagine storage
Unknown action=Azione sconosciuta
Unknown version=Versione sconosciuta
Unraid Mount tag=Tag per il mount Unraid
Unraid Share=Share di Unraid
Updating=Aggiornamento
USB Controller=Controller USB
USB Devices=Dispositivi USB
vDisk Bus=Bus vDisk
vDisk Location=Posizione vDisk
vDisk Size=Dimensione vDisk
vDisk Type=Tipo vDisk
vDisks=vDisk
Verifying=Verifica
video for VNC=video per VNC
VirtIO Drivers CDRom Bus=Bus dek Driver CDRom VirtIO
VirtIO Drivers ISO=ISO dei Driver VirtIO
Virtual Machines=Macchine Virtuali
VM creation error=errore creazione VM
VM image deletion error=errore cancellazione immagine VM
VNC Keyboard=Tastiera VNC
VNC Password=Password VNC
VNC Video Driver=Driver Video VNC
VNC=VNC
Wasnt able to stop the process=Non ho potuto fermare il processo
Windows 7XP=Windows 7/XP
Windows 82012, newer Linux distros=Windows 8/2012, nuove distro Linux
XML View=Visualizza XML

; Note: April 29, 2023 - 34 missing translations
9p Mode=
Boot Order=
Boot order=
define OS boot options=
Eject CD Drive=
Enable USB boot=
Guest agent not installed=
Guest not running=
Insert CD=
Insert=
ISO Image=
Lock sortable items=
Network Source=
No CD image inserted in to drive=
Optional=
port for virtual console=
protocol for virtual console=
Select=
Serial=
Unlock sortable items=
Unraid Mount Tag=
Unraid Share Mode=
Unraid Source Path=
Virtiofs Mode=
Virtual=
VM Console AutoPort=
VM Console enable Copypaste=VM Console enable Copy/paste
VM Console Keyboard=
VM Console Password=
VM Console Port=
VM Console Protocol=
VM Console Video Driver=
VM Console WS Port=
wsport for virtual console=
